###################
###################
###################
###################
###################
###################
#############MMM###
######MMMMM##MPM###
###MMMMgggMMMMgMMM#
#MMMgggggggggMgggM#
#MgggggggggggMgggM#
#MMMMgggMggggggggM#
####MMMMMMMMMMMMMM#
###################
###################
