###################
###################
###################
###################
###################
###################
#############MMM###
#############MgM###
###MMMMMMMMMMMgMMM#
#MMMgggggggggggggM#
#MPggggggggggggggM#
#MMMMggggggggggggM#
####MMMMMMMMMMMMMM#
###################
###################
